GMR = "countries/GrandMastersRealm.txt"
NPC = "countries/NorthernPlains.txt"
RMT = "countries/Rimatu.txt"
LIR = "countries/Lirothlind.txt"
BLD = "countries/Bilodya.txt"
IRI = "countries/Irinthios.txt"
TLA = "countries/Tlarthingia.txt"
MER = "countries/MerchantsHand.txt"
KUR = "countries/Kurguria.txt"
SKA = "countries/Skaelinger.txt"
RTH = "countries/Rthauiaur.txt"
EOR = "countries/Eastern Ordoria.txt"
ORD = "countries/Ordoria.txt"
ORB = "countries/Ordoria Rebels.txt"
IST = "countries/Istaroth.txt"
VAR = "countries/Varinthia.txt"
YTH = "countries/Ythelmare.txt"
VUD = "countries/Vuid.txt"
BER = "countries/Bergialer.txt"
PRK = "countries/Perkavland.txt"
TAR = "countries/Tarnland.txt"
MOL = "countries/Moliva.txt"
CAL = "countries/Calezzio.txt"
GET = "countries/Getaland.txt"
DIA = "countries/Dialand.txt"
ITH = "countries/Ith.txt"
KEL = "countries/Kel.txt"
GOW = "countries/Gowie.txt"
SUL = "countries/Sulfurisle.txt"
TES = "countries/Tesliran.txt"
TRX = "countries/Thryxvanor.txt"
HIH = "countries/HighHall.txt"
DEL = "countries/El.txt"
STB = "countries/Stabba.txt"
SAL = "countries/Salnland.txt"
THA = "countries/Tharothep.txt"
AGE = "countries/Ageless.txt"
AKS = "countries/Akkanid.txt"
AET = "countries/Aethell.txt"
TRS = "countries/Tristal.txt"
HAS = "countries/Hastalia.txt"
QUA = "countries/Quarralani.txt"
STP = "countries/StompingGrounds.txt"
EOK = "countries/Eokgi.txt"
ROT = "countries/Tears.txt"
IRT = "countries/Ierethayne.txt"
KRT = "countries/Kortinall.txt"
NAS = "countries/Nastrodoge.txt"
FEL = "countries/Felweyne.txt"
TRI = "countries/Trifell.txt"
KAL = "countries/Kaltire.txt"
NAV = "countries/Navandonne.txt"
UNG = "countries/Ungerdal.txt"
ARK = "countries/Arkanisturm.txt"
ARB = "countries/Arkanisturm Rebels.txt"
TEI = "countries/Teigerholen.txt"
STA = "countries/Stahlhof.txt"
NOC = "countries/Nochwald.txt"
WIS = "countries/Wistingen.txt"
SNF = "countries/Schneefilde.txt"
SVT = "countries/StVichtlas.txt"
SPW = "countries/Spochwald.txt"
NRK = "countries/Neureik.txt"
FTH = "countries/Fritzhafen.txt"
WSZ = "countries/Wertszvorde.txt"
HLZ = "countries/Holzbrenn.txt"
FAU = "countries/Faustburg.txt"